1111111111111
10000000000C1
1P000000000E1
1111111111111