111111111111111111111111111111111111
1P100010000000000000C000000000000001
101010101111111111111111111111111101
1010101010000000000C0000000000000101
101010101011111111111111111111110101
101010101010000000000000000000010101
10101C101010111111111111111111010101
10101010101010000C000000000001010101
101010101010101111111111111101010101
101C10101010101000CX000000E101C10101
10101010101010000000000000C101010101
1010101C1010111111111111111101010101
1010101010100C0000000000000001010101
101010101011111111111111111111010101
101010101C000000000000000000000101C1
101010101111111111111111111111110101
10101010000000C000000000000000000101
1C1010111111111111111111111111111101
100010000000000C00000000000000000001
111111111111111111111111111111111111