1111111111111111111
10000000000C1111111
10000C11110111110E1
10001111100C0110011
1001111000110100111
1P11110001100001111
1111000011110011111
1111111111111111111